


F 232,172,144

NO   texture/path_to_the_north_texture.xpm
SO   texture/path_to_the_south_texture.xpm
WE   texture/path_to_the_west_texture.xpm
EA  texture/path_to_the_east_texture.xpm



C 13, 152, 186




1111111111111111111111111
1010000000110000000000001
1100000001110000000000001
1001000000000000000000001
111111111011000001110000011111111
100000000011000001110111111111111   
11110111111111011100000010001111           
11111011111111001110101001000111
11111111111111011111111111111111          
1111111111111100000000111      
           1110010010111
           10001001010111           
           10100000010111
           110100N1010111    
111111111111100100100111111
11000000110101000100010010011
10000000000000000000000000001
10000000000000001101010010001
11000001110101011111011110001
11110111 1110101 101111010001
11111111 1111111 111111111111
