NO   texture/path_to_the_north_texture.xpm   
SO   texture/path_to_the_south_texture.xpm
WE   texture/path_to_the_west_texture.xpm
EA   texture/path_to_the_east_texture.xpm




C 0, 0,         255   
F 173,216,230

111111111111111111111111
10000000000N000000000001
100000000000000000000001
100000000000000000000001
100000001000000100000001
100000010000000010000001
100000100000000001000001
100001000000000000100001
100001000000000000100001
100000100000000001000001
100000011000000110000001
100000000000000000000001
111111111111111111111111

