C 0, 0,     0

NO texture/path_to_the_north_texture.xpm
SO texture/path_to_the_south_texture.xpm
WE texture/path_to_the_west_texture.xpm
EA texture/path_to_the_east_texture.xpm


D1 texture/scifidoor.xpm


F 192,     192,    192


1111111111111111111111111111111111111111111111111111111111111111111
100000000000000001D100000000000000000000000000000000000000000000001
1000000000000000010111111111111000000111111110000000000000000111101
1111111100000000010100000000000000000000000000000001111111100001101
111000000000000001100000000000000000000000000000011111110000100101
1100000000000000111111111111111100001110000000000000011100011010101
1000000000000000010000000000000000000000000000000000110000010000101
1000000011111111000001111111111000000000000000000000000000000011001
1000000000011111111000111110000000000000111111110000000011000001011
1000000000001111111110000000000000N00000D00000000000100000111101011
1000000001111111100000011110000000000000100000000000000110000001011
1000000000000000000000011100000000000011111111000000001000001011011
1000000000111111110000000010000000000000000000000000001100000011011
1000000000000000000000000111111110001111111111110000000000001111011
1000000000111111110000000011111111D11111111111110000000000000000011
1000000000000000000000000000000000000000000000000010000000111001101
1000000000000000000111111111111110000011111111000010000011100000101
1000000000000000000000000000000000000000000000000001000001101101101
1000111111110000000011111111000000000000000000000000001100000001101
1000000000000000000000000000000000000000000000001100000000110101101
1111111100000000000000000000000001000111111111111111111111110101101
1000000000000000000000000000000000000000000000000000001100110101101
1000000000000000000000000000000000000000000000000000001100110101101
1000000111111111111111111111111000000000000000000000000011110101101
1000000000000000000000000000000000000000000000000000000011100101001
1000000000000000000000000000000001111111111111111000000000000101011
1000000000000000000000000000000000000000000000000000000000111101011
1000000000000000000000000000000000000000000000000000000000111100011
1111111111111111111111111111111111111111111111111111111111111111111


