F 173,     216,    230

NO   texture/path_to_the_north_texture.xpm
SO   texture/path_to_the_south_texture.xpm
WE   texture/path_to_the_west_texture.xpm
EA  texture/path_to_the_east_texture.xpm



C 0, 105,     12




11111111111111111111111111111111
10000000000000000000000000000001
10000000000000000000000000000001
10001111111111111111111111100001
100001000000000000000110000000001
10000010000000000000110000000001
10000001000000000000001000000001
10000000100000000000001000000001
1000000100000000N000011101000001
10000110000000000000000100000001
10000100000000000000000110000001
10000001000000000000000010000001
10011111111100000011111000000001
10000000000100000100000000000001
10000000000001001000000000000001
10000000000000110000000000000001
10000000000000000000000000000001
11111111111111111111111111111111
