C 0, 0,     0

NO texture/path_to_the_north_texture.xpm
SO texture/path_to_the_south_texture.xpm
WE texture/path_to_the_west_texture.xpm
EA texture/path_to_the_east_texture.xpm



F 192,     192,    192


111111111111111111111111
10000000000S000000000001
100000000000000000000001
100000000000000000000001
101010101010101010101011
110101010101101101010101
100000100000000001000001
100001000000000000100001
100001000000000000100001
100000100000000001000001
100000011000000110000001
100000000000000000000001
111111111111111111111111

